######## #
######## #
##     B #
## ##   ##
##      ##
###A######
